XXXXXXXXXXXXXXXXXXXXXXXXXXXXXXXXXXXXXXXXXXXXXXXXX
X                                               X
X                                               X
X                                               X
X       XXXXXX                  XXXXXX          X
X             X                X                X
X              X              X                 X
X               XXX        XXX                  X
X                                               X
X                      X                        X
X                     XXX                       X
X                    X X X                      X
X                   X  X  X                     X
XXXXXXXXXXXXXXXXXXXXXXXXXXXXXXXXXXXXXXXXXXXXXXXXX